1,2,1,0,3
5,1,2,3,2
0,1,2,3,4
1,2,3,5,1
4,3,3,3,1